#	#	#	#	#	#	#	#	#	#	#	#	#	#	#	#	#	#	#	#	#	#	#	#	#	#	#	#	#	#	#	#	#	#	#	#	#	#	#	#	#	#	#	#	#	#	#	#	#	#	#
S	.	#	.	.	.	.	.	.	.	.	.	.	.	.	.	.	.	.	.	.	.	.	.	.	.	.	.	.	.	#	.	.	.	.	.	.	.	.	.	.	.	.	.	#	.	.	.	.	.	#
#	.	#	#	#	#	#	.	#	#	#	#	#	#	#	#	#	#	#	#	#	#	#	#	#	#	#	#	#	.	#	.	#	#	#	.	#	#	#	#	#	#	#	.	#	#	#	.	#	.	#
#	.	#	.	.	.	.	.	.	.	.	.	.	.	.	.	.	.	.	.	#	.	.	.	.	.	#	.	.	.	#	.	#	.	.	.	#	.	#	.	.	.	#	.	.	.	#	.	#	.	#
#	.	#	.	#	#	#	.	#	.	#	#	#	#	#	#	#	#	#	.	#	.	#	#	#	.	#	.	#	#	#	#	#	.	#	#	#	.	#	.	#	.	#	#	#	.	#	#	#	.	#
#	.	#	.	#	.	#	.	#	.	#	.	.	.	#	.	.	.	#	.	.	.	#	.	#	.	#	.	#	.	.	.	.	.	#	.	.	.	#	.	#	.	.	.	.	.	#	.	.	.	#
#	.	#	#	#	.	#	.	#	#	#	.	#	.	#	.	#	.	#	#	#	#	#	.	#	.	#	.	#	#	#	.	#	#	#	.	#	#	#	.	#	#	#	#	#	#	#	.	#	.	#
#	.	.	.	.	.	#	.	.	.	.	.	#	.	#	.	#	.	#	.	.	.	.	.	#	.	#	.	.	.	.	.	#	.	.	.	#	.	.	.	#	.	.	.	.	.	.	.	#	.	#
#	#	#	.	#	#	#	#	#	#	#	#	#	.	#	.	#	.	#	.	#	.	#	#	#	.	#	#	#	#	#	#	#	.	#	.	#	.	#	#	#	.	#	#	#	#	#	#	#	.	#
#	.	#	.	#	.	.	.	.	.	.	.	#	.	#	.	#	.	#	.	#	.	.	.	#	.	.	.	.	.	.	.	.	.	#	.	#	.	.	.	#	.	#	.	.	.	#	.	.	.	#
#	.	#	.	#	.	#	#	#	#	#	.	#	.	#	.	#	#	#	.	#	#	#	.	#	#	#	#	#	#	#	.	#	#	#	#	#	#	#	.	#	.	#	#	#	.	#	.	#	#	#
#	.	#	.	#	.	.	.	#	.	#	.	#	.	#	.	.	.	.	.	#	.	.	.	#	.	.	.	#	.	.	.	#	.	.	.	.	.	.	.	#	.	.	.	#	.	.	.	.	.	#
#	.	#	.	#	#	#	.	#	.	#	.	#	.	#	#	#	#	#	#	#	.	#	.	#	.	#	#	#	.	#	#	#	.	#	#	#	#	#	#	#	#	#	.	#	#	#	#	#	#	#
#	.	#	.	#	.	#	.	#	.	.	.	#	.	#	.	.	.	.	.	.	.	#	.	.	.	#	.	.	.	#	.	.	.	#	.	.	.	.	.	.	.	#	.	.	.	.	.	.	.	#
#	.	#	.	#	.	#	.	#	.	#	#	#	.	#	.	#	#	#	#	#	#	#	#	#	.	#	.	#	#	#	.	#	#	#	.	#	#	#	#	#	.	#	.	#	#	#	#	#	.	#
#	.	.	.	#	.	#	.	#	.	.	.	.	.	#	.	#	.	.	.	.	.	#	.	.	.	#	.	.	.	#	.	#	.	.	.	#	.	#	.	.	.	#	.	#	.	.	.	.	.	#
#	.	#	#	#	.	#	.	#	#	#	#	#	#	#	.	#	.	#	#	#	#	#	.	#	#	#	#	#	.	#	.	#	.	#	#	#	.	#	.	#	#	#	#	#	.	#	#	#	.	#
#	.	.	.	.	.	#	.	.	.	#	.	.	.	.	.	#	.	#	.	.	.	.	.	.	.	.	.	#	.	#	.	.	.	#	.	.	.	#	.	#	.	.	.	.	.	#	.	#	.	#
#	#	#	#	#	.	#	#	#	.	#	#	#	.	#	.	#	.	#	.	#	#	#	#	#	#	#	.	#	.	#	#	#	#	#	.	#	.	#	.	#	.	#	#	#	#	#	.	#	.	#
#	.	.	.	#	.	.	.	#	.	.	.	#	.	#	.	#	.	.	.	#	.	.	.	#	.	.	.	#	.	.	.	.	.	#	.	#	.	.	.	#	.	.	.	#	.	.	.	#	.	#
#	.	#	#	#	#	#	.	#	#	#	.	#	#	#	.	#	.	#	#	#	.	#	.	#	#	#	.	#	#	#	#	#	.	#	.	#	#	#	#	#	#	#	.	#	.	#	.	#	.	#
#	.	.	.	.	.	#	.	.	.	#	.	.	.	#	.	#	.	.	.	.	.	#	.	.	.	#	.	.	.	.	.	#	.	#	.	.	.	#	.	.	.	#	.	#	.	#	.	#	.	#
#	#	#	.	#	.	#	#	#	.	#	#	#	.	#	.	#	#	#	#	#	.	#	#	#	.	#	#	#	.	#	.	#	.	#	#	#	.	#	.	#	.	#	.	#	.	#	#	#	.	#
#	.	.	.	#	.	#	.	.	.	#	.	.	.	#	.	.	.	.	.	.	.	#	.	.	.	#	.	#	.	#	.	.	.	.	.	#	.	.	.	#	.	.	.	#	.	.	.	#	.	#
#	.	#	#	#	.	#	.	#	#	#	.	#	#	#	.	#	#	#	#	#	#	#	.	#	#	#	.	#	.	#	#	#	#	#	.	#	#	#	#	#	#	#	#	#	#	#	.	#	.	#
#	.	#	.	.	.	#	.	.	.	#	.	.	.	#	.	.	.	#	.	.	.	#	.	#	.	.	.	#	.	#	.	.	.	#	.	.	.	.	.	#	.	.	.	.	.	.	.	#	.	#
#	.	#	#	#	#	#	#	#	.	#	#	#	.	#	#	#	.	#	.	#	.	#	.	#	.	#	#	#	.	#	.	#	.	#	#	#	#	#	.	#	.	#	#	#	.	#	.	#	.	#
#	.	.	.	.	.	.	.	#	.	#	.	#	.	#	.	.	.	#	.	#	.	#	.	#	.	.	.	.	.	#	.	#	.	.	.	.	.	#	.	#	.	#	.	.	.	#	.	#	.	#
#	.	#	#	#	#	#	.	#	.	#	.	#	.	#	.	#	#	#	.	#	.	#	.	#	.	#	#	#	#	#	.	#	.	#	.	#	#	#	.	#	.	#	.	#	#	#	#	#	.	#
#	.	.	.	.	.	#	.	.	.	.	.	.	.	#	.	#	.	.	.	#	.	.	.	.	.	#	.	.	.	.	.	#	.	#	.	#	.	.	.	#	.	#	.	.	.	.	.	#	.	#
#	#	#	#	#	.	#	#	#	#	#	#	#	.	#	.	#	.	#	#	#	#	#	#	#	#	#	.	#	#	#	#	#	.	#	#	#	.	#	#	#	.	#	#	#	#	#	.	#	.	#
#	.	.	.	#	.	#	.	.	.	#	.	.	.	#	.	#	.	.	.	.	.	.	.	.	.	.	.	.	.	.	.	#	.	.	.	.	.	#	.	.	.	#	.	.	.	#	.	#	.	#
#	.	#	#	#	.	#	#	#	.	#	.	#	#	#	.	#	#	#	#	#	#	#	#	#	#	#	#	#	#	#	#	#	#	#	#	#	#	#	.	#	#	#	.	#	.	#	.	#	.	#
#	.	.	.	.	.	.	.	.	.	#	.	.	.	.	.	.	.	.	.	.	.	.	.	.	.	.	.	.	.	.	.	.	.	.	.	.	.	.	.	.	.	.	.	#	.	#	.	.	.	#
#	#	#	#	#	#	#	#	#	#	#	#	#	#	#	#	#	#	#	#	#	#	#	#	#	#	#	#	#	#	#	#	#	#	#	#	#	#	#	#	#	#	#	#	#	#	#	#	#	F	#
